##########
#S     # #
# ### ## #
#   #    #
### #### #
#      # #
# #### # #
#    #   #
# ## ###E#
##########
